###############
#.....#.......#
#..E..#..#....#
#.....#..#....#
#..#####..#...#
#.............#
#..P......E...#
###############